    ##########
#            #
#            #
#            #
##############