##############
#            #
#    ##      #
#            #
##############