##############
#            #
#    ##      #
#            #
#            #
#         ####
##############