##############
#            #
#            #
#            #
##########    